111111111111111111111111111
1PCCCC111CCCCCCCCCCCCCCCCC1
11CCCCCCCCCCCCC1111111111C1
1111CCCCC11111C111111111CC1
11111101111111C11111111CCC1
11111101111111C1111111CCCC1
111111111111111111111CCCCC1
1ECCCCCCCCCCCCCCCCCCCCCCCC1
111111111111111111111111111
